NO ./textures/bonus1.png
SO ./textures/bonus2.png
WE ./textures/bonus3.png
EA ./textures/bonus4.png

C 40,40,40
F 120,50,60



        1111111111111111111111111
        1000000000110000000000001
        10110000000100000N0000001
        1001000000020000000000001
111111111011000001110000000000001
100000000011000001112111112111111
11110111111111011100000010001
11110111111111020001010010001
11000000110101011100000010001
10000000000000001100000020001
100000 0000000000201010010001
1100000111010101111101111000111
11110111 1110101 102011010001
11111111 1111111 111111111111
