NO ./textures/north_texture.png
SO ./textures/south_texture.png
EA ./textures/east_texture.png
WE ./textures/west_texture.png

F 220,100,0
C 225,30,0

11111111        11111111111
10000001111     10000000001
100110000001    10000N00001
1001 1000000111 11110001111
100010011100001 11110001111
10000001 100111 11111111111
1000000110101
 111100000001
1000000000001
10101110100001
10001 1001101
 111   11  1